study	研究
vegetable	蔬菜
lincoln	林肯
persecuting	迫害
simulation	模拟
accustomed	习惯
totem	图腾
suppressed	抑制
exits	出口
insisted	坚持
student	学生
disarrayed	弄乱
appearance	外观
interest	兴趣
violently	猛烈
history	历史
brick	砖
interesting	有趣的
holiday	假日
patted	拍
stamped	冲压
practice	实践
members	成员
fan	风扇
bars	酒吧
owner	业主
unfortunate	不幸
brightness	亮度
dishing	碟
panned	镜头
winning	获奖
examined	检查
25	25
couple	夫妇
ohio	俄亥俄
moment	时刻
irritable	烦躁
break	打破
korps	军团
cha	茶
studded	镶嵌
unit	单元
lawn	草坪
drowning	溺水
attractive	吸引力
delivery	交付
moister	湿润的
branch	分支
giggled	咯咯地笑
watching	看
orleans	奥尔良
ostracized	排斥
leading	领导
week	周
franglian	franglian
suspected	疑似
la	La
who	谁
scratched	划伤
faceted	刻面
liquidated	违约
interruptions	中断
questions	问题
enthused	热情
continuing	继续
bun	BUN
must	必须
finding	发现
outfit	装
protected	保护
litter	垃圾
background	背景
wrist	手腕
low	低
sneezed	打喷嚏
explains	解释
ups	UPS
sniffling	抽噎
tasty	美味
dumping	倾销
astounded	震惊
nebulae	星云
polite	礼貌
removed	删除
anyplace	地方
gidget	宝贝
curled	卷曲
supporting	支持
concept	概念
arabs	阿拉伯人
obligations	义务
speed	速度
height	高度
roads	道路
penny	分钱
day	天
conversing	交谈
impatiently	不耐烦地
hills	山
scuffing	划伤
pole	极
amiably	和蔼可亲地
marley	马利
y	Y
presence	存在
6729	6729
six	六
mount	山
means	手段阴险
sssh	嘘
begin	开始
500	500
covers	涵盖
fee	费
badge	徽章
chocolate	巧克力
central	中央
1814	1814
weight	重量
lifeless	生命的
exclaimed	惊呼
coin	硬币
closing	关闭
fake	假
admitted	承认
crashes	崩溃
scientist	科学家
hubcap	轮毂
mozzarella	芝士
thicket	丛林
motioned	示意
recording	记录
sub	子
caused	引起
sports	体育
visions	愿景
joke	笑话
signalled	示意
chime	编钟
learns	学习
whipped	鞭打
dust	尘
fidelity	富达
78	78
depreciation	折旧
make	使
body	体
grillwork	花格
hang	挂
waldo	瓦尔多
belong	属于
faded	褪色
cave	洞穴
s	的
brandy	白兰地
wants	希望
wanted	想
pa	PA
cyberspace	网络
unconvinced	不服气
caveman	穴居人
nanosecond	纳秒
tasteless	无味
scaly	鳞片组成的
conjectured	推测
commented	评论
framistatter	framistatter
allow	允许
burying	埋
else	别的
childrens	儿童
vhere	这
drop	滴
germans	德国人
italy	意大利
control	控制
010f	010f
potato	马铃薯
win	赢得
doubled	翻倍
split	分裂
virtual	虚拟
lighted	点燃
whom	谁
unsatisfied	满意
argument	争论
letcha	让你
movin	movin
tools	工具
catching	捕捉
extra	额外
chust	丘斯特
chick	小鸡
plots	地块
title	标题
flies	苍蝇
lunch	午餐
off	关闭
inquired	问
rust	锈
imposing	气势
voices	声音
heinz	海因茨
vertigo	眩晕
snidely	全面
footsteps	脚步
silence	沉默
blasters	放炮
battled	在
vacuous	空洞的
r	R
alter	改变
torchlights	torchlights
deposit	存款
whose	的
sputtered	溅射
educational	教育
petulantly	任性
moderate	适度的
ball	球
indianapolis	印第安纳波利斯
squid	鱿鱼
beginning	开始
safe	安全
contain	包含
wrapper	包装
temple	寺
confines	范围
offensive	进攻
jersey	球衣
president	总统
giggle	傻笑
jackboot	长筒靴
jiminy	吉米尼
dazzled	眼花缭乱
30	30
john	约翰
cliff	悬崖
sucked	吸
dial	拨号
midi	MIDI
lederhosen	皮裤
prancing	腾跃
succeeded	成功
foofaraw	褶边
pounded	捣
forest	森林
10	10
roughly	大约
gingerly	小心翼翼地
trmp	TRMP
laws	法律
amazing	惊人的
demon	恶魔
bushes	灌木丛
gold	金
live	活
plastic	塑料
henri	亨利
respond	回应
rasta	RASTA
likes	喜欢
porch	门廊
nonsense	废话
satisfactory	满意
hordes	成群
pushing	推方式
caribbean	加勒比
their	他们
reverie	遐想
hanging	挂
treads	踏
program	程序
patients	患者
forgets	忘记
warmer	温暖
slapping	拍打
campfire	篝火
goombah	老兄
guilt	内疚
kingdom	王国
memory	记忆
serve	服务
coax	哄
lunged	扑
sympathetically	同情
pleadingly	恳求
high	高
zeroing	零
assume	承担
filmy	朦胧的
keep	保持
raising	提高
thud	砰的一声
attempt	尝试
ideas	设计思路
fiendish	残忍的
curious	好奇
pageants	选美
oughta	应该
page	页
about	约
bears	熊
raisins	葡萄干
tailgate	挡板
insert	插入
inn	酒店
accelerator	加速器
referred	称
hesitated	犹豫
detail	细节
patronizing	光顾
imagine	想象
languages	语言
gently	轻轻
longed	渴望
tigers	老虎
crush	粉碎
constructing	构建
redundant	冗余
freud	佛洛伊德
framed	框架
looking	寻找
wilbur	威尔伯
011f	011f
movement	运动
plotted	绘制
furiously	疯狂
gardens	花园
bulging	胀
notarized	公证调解
gables	山墙
agitated	激动
zem	ZEM
clear	清晰
flickered	在
raping	强奸
steel	钢
ears	耳朵
consequences	后果
tremendously	非常
coming	来
vant	很多相关
66	66
language	语言
brow	额头
ugliest	丑
desperate	绝望
recall	召回
dogmatic	教条
pounding	碰撞
eating	吃
upsetting	镦
cracking	开裂
ghastly	可怕的
actual	实际
application	应用
periodically	定期
reasoned	理性
stumbled	跌跌撞撞
setting	设置
agency	社
unconcernedly	漫不经心地
slot	槽
jaws	颌
colored	彩色
knowing	知道
shoes	鞋
refrigerator	冰箱
halfheartedly	敷衍了事
cube	立方体
barada	Barada
beside	旁边
dropped	下降
20	20
beamed	微笑
dum	dum
hero	英雄
trap	陷阱
productive	生产
playing	打
seep	渗透
continuum	连续
fluffing	起毛
cereal	谷物
merry	快乐
studied	研究
proudly	自豪地
begged	恳求
red	红
correct	正确
drift	漂移
slick	光滑
putting	把
eye	眼
stopped	停止
saner	理智的
95;	95
newspaper	报纸
receive	收到
crying	哭
edible	食用
smiling	微笑
helping	帮助
collect	收集
ahead	提前
debts	债务
gene	基因
begun	开始
brought	带来
play	玩
wrapped	包裹
expenses	费用
range	范围
vithout	不能
pouted	撅着
beans	Ronettes豆
tried	尝试
budget	预算
flaming	火红的
ate	吃
existence	存在
snifter	酒杯
vacuumed	真空
administration	管理
deadbeat	赖账的
rand	兰德
hacking	黑客
landed	降落
unhappily	不幸
rubbing	搓
lens	镜头
go;	去
gap	差距
hail	冰雹
pillaging	掠夺
as	作为
silver	银
led	LED
remains	仍然
yup	是
suggestions	建议
stitches	针
disappointed	失望
pleaded	承认
maintenance	维护
routine	常规
shrieked	尖叫
replaced	取代
including	包括
calling	调用
cartoon	卡通
launched	推出
swear	发誓
malfunctioning	故障
admission	录取
cradled	抱
suppose	想
snorted	哼了一声
tossing	折腾
shame	羞耻
headset	耳机
filigreed	聪明
fantastic	神奇的
requisition	征用
biology	生物学
assented	同意
slavemasters	奴隶主
shake	摇
nuked	核爆
menacing	来势汹汹的
sputter	溅射
tolerate	容忍
created	创建
wheeled	轮式
brains	大脑
moan	呻吟
toreador	斗牛士
flat	平
college	大学
fate	命运
sarcasm	讽刺
within	内
warming	气候变暖
keeper	门将
packed	包装
pineapple	菠萝
lawyer	律师
wildflowers	野花
rhythm	节奏
quizzically	疑惑地
possessed	具有
uproariously	大笑
relative	相对
infinity	无限
guitars	吉他
fiend	恶魔
change	改变
rim	RIM
distance	距离
rows	行
role	作用
husband	丈夫
clenched	握紧
met	遇到
ruefully	苦笑
peeked	偷看
robots	机器人
loomed	隐约
castles	城堡
luck	运气
wow	哇
uprising	起义
strange	奇怪的
minds	头脑
discovery	发现
cause	引起
error	误差
them	他们
menace	威胁
complete	完整的感觉
certain	一定
ironed	熨
bopping	送
grass;	草
flops	拖鞋
modestly	虚心
immobile	固定
explosion	爆炸
gathered	聚集
explanation	解释
objects	对象
block	块
gleam	一线
failed	失败
jmp	JMP
premiums	费
hotel	酒店
irritably	火爆
got	奇迹了
suspect	犯罪嫌疑人
security	安全
exit	退出
center	中心
speaks	说
strode	大步
pupils	学生
beach	海滩
warning	警告
followed	之后
motion	运动
brew	酿造
tops	顶
improved	改进
spoil	破坏
fountain	喷泉
cane	甘蔗
whatcha	你
caves	洞穴
nearby	附近
show	显示
license	许可
fantasies	幻想
surface	表面
mumble	咕哝
thank	谢谢
yourselves	自己
lesbians	女同性恋
gonna	会
wearing	穿
astonishment	惊讶的是
bid	投标
german	德国
form	形式
pluribus	合众
fact	事实
concerned	关注
matter	物质
cannot	不能
monsters	怪物
phonograph	留声机
lemon	柠檬
quit	退出
hard	硬
tugged	拖着
entrance	入口
heads	头
0001	0001
complicated	复杂了
rty	党的
hmmm	嗯
patsy	帕齐
hand	手
above	以上
follow	遵循
larger	大
making	制作
someplace	某处
cradling	抱
captain	队长
ruining	毁掉
threatened	威胁
words	词
appropriate	适当
legend	传奇
declared	宣布
though	虽然
makes	使
victor	维克多
noticed	注意到
pursuit	追求
relish	津津乐道
cursed	诅咒
hurried	匆匆
mine	矿山
git	Git
returning	返回
fury	愤怒
4	4
seal	密封
considering	考虑
goldfish	金鱼
electric	电
shook	摇
deadpan	面无表情的
temporary	临时
swinging	摆动
heart	心重播
push	推
spots	点
adjusted	调整
slicked	梳
movie	电影
exasperated	激怒
toying	玩弄
sank	沉没
remote	远程
um	嗯
24	24
corrosion	腐蚀
mouth	口
transmitter	发射机
shoot	拍摄
less	少
flitted	掠过
large	大
aversion	厌恶
dirty	脏
triumphantly	成功的
hands	手
insists	坚持
myself	自己
desks	课桌
closed	封闭
appearing	出现
awaited	等待
nope	不
fine	细
mean	平均
flintstones	摩登原始人
here;	这里
acquired	获得
subterfuge	托词
brilliant	辉煌
hungry	饿
ernest	厄内斯特
fluorescent	荧光
shaken	动摇
unknown	未知的
cadillac	凯迪拉克
stunned	惊呆了
staggering	惊人的
guess	猜
covered	覆盖
finger	手指
gardener	园丁
friendly	友好
wheel	轮
welled	涌
thinking	思维
ornate	华丽的
read	读
doing	做
compensate	补偿
open	开放
gotten	得到
especialmente	especialmente
surprised	惊讶
bullet	子弹
countryside	农村
improve	提高
rhyme	韵
phrm	善用公屋资源
observed	观察
encampment	营地
tyrant	暴君
puffing	膨化
sometimes	有时
situations	情况
fingertips	指尖
king	王
jackson	杰克逊
jokes	笑话
missed	错过
tightly	紧紧
shower	淋浴
cottage	山寨
ing	ING
works	作品
desk	桌
confusion	混乱
commotion	骚动
authority	权威
war	战争
trained	训练
reduction	还原
blasted	炸
cattle	牛
until	直到
chains	链
timex	天美时
determines	决定
fellow	研究员
messages	消息
picking	采摘
ahhh	啊
faraway	遥远的
faint	微弱
3	3
stadium	体育场
tactile	触觉
standing	站
rings	环
hungarian	匈牙利
bolted	螺栓
pillaged	掠夺
trash	垃圾
meant	意味着
frustrated	沮丧
torn	撕
or	或
human	人
pen	笔
failure	失败
admit	承认
neighborhood	附近
map	地图
rape	强奸
shapes	形状
crater	坑
rum	朗姆酒
wound	伤口
peculiar	特有的
blood	血
home	家
helpless	无奈
sensitive	敏感
north	北
barking	吠
arrangements	安排
unconsciously	不知不觉
morosely	愁眉苦脸地
moines	Moines
notre	圣母
pilot	试点
elsewhere	别处
em	EM
skeptically	怀疑
fast	快速
puttink	puttink
passing	传递
un	联合国
gilligan	Gilligan
criticisms	批评
friend	朋友
discovered	发现
gentle	温柔
surfboards	冲浪板
saucer	碟
tub	浴缸
necktie	领带
delicious	美味
zillion	无数
cosmic	宇宙
scampered	奔跑
rod	杆
f	F
immobilized	固定
warned	警告
anxiously	焦急地
breeches	马裤
purple	紫色
a	一
throw	扔
distorted	扭曲
windows	Windows
job	工作
beheld	看见
big	大
gets	获取
theatrically	戏剧性的
2392a	2392a
nature	自然
fashion	时尚
muzak	Muzak
soothingly	安慰
paused	暂停
solve	解决
businesses	企业
name	名字
am	是
starvation	饥饿
aside	一边
abruptly	突然
base	基地
mondays	周一
carmen	卡门
during	期间
simpered	通过
pass	歇斯底里地傻笑
lousy	烂
unfroze	解冻
ba	八
0d	0d
approprite	的
tactics	策略
195	195
synthesized	合成
recollection	回忆
whinnied	嘶鸣
disgustedly	厌烦地
movie;	电影
dream	梦
classical	古典
definitely	绝对
lemme	我
sake	而
poison	毒
lumpy	块状
865	865
bavaria	巴伐利亚
savages	野人
carry	携带
rang	响
unsheathed	出鞘
rock	岩
struck	打
bureau	局
evolve	进化
twitching	抽搐
vorry	vorry
froze	冻结
proves	证明
puffed	膨化
difficulty	难度
startling	惊人
cheer	加油
streaming	流
pockmarked	麻子
policeman	警察
attention	注意
graffiti	涂鸦
depressed	沮丧极
sparkly	应该
ought	闪闪发光
rather	而
thwart	阻挠
steps	步骤
famous	著名
introducing	引入
had	有
purposefully	故意
badly	严重
stiffen	僵硬
shtopped	shtopped
tipping	翻
short	短
furled	收拢
positively	正
shrill	刺耳的
straining	使劲
curdling	凝结
austrian	奥地利
swaying	摇曳
relieved	如释重负
memory;	记忆
absorbed	吸收
forbid	禁止
smelled	闻到
dress	服饰
surrendering	投降
keeps	保持
stove	炉
in	在加冕
radio	无线
accepted	接受
enquired	打听
doorway	门口
shoulders	肩膀
facet	面
miranda	米兰达
squeezing	挤压
snappishly	尖刻地说
bad	坏
sent	送
just	只是
health	健康
unparalleled	无与伦比的
rage	愤怒
flipper	脚蹼
shock	冲击
loincloths	腰带
nuke	核
boomed	蓬勃发展
dishes	菜
striding	大步
spirits	精神
glum	闷闷不乐地
linking	连接
bugs	虫子
precipice	悬崖
mysterious	神秘
considerate	体贴的
any	任何
hostile	敌对
doesn	并
capable	能够同时
meinself	meinself
excitedly	兴奋地跳
clark	克拉克
tales	故事
ornamentation	纹饰
icebox	冰箱
dour	阴沉的
glaring	耀眼的
will	将
outstretched	伸出
american	美国
stalk	秸秆
accounts	账户
inadequate	不足
laugh	笑
shot	镜头
paws	爪子
wall	壁
spacious	宽敞的
reproved	责备
teacups	茶杯
terrain	地形
shade	阴影
debt	债务
rolling	滚动
figured	想
sympathetic	交感
cosmos	宇宙
respire	呼吸
speculated	猜测
sight	视线
hoow	hoow
fellas	伙计
volunteered	自愿
units	单位
towered	耸立
russian	俄罗斯
otherwise	否则
retorted	反驳
stray	流浪
to	到
smuggled	走私
egg	蛋
burped	打嗝
touch	触摸
giddy	头晕
stolen	被盗
distracted	分心
shadows	阴影
shuffled	慢吞吞的
ready	准备
heard	听到
wouldn	就
61	61
warn	警告
approach	方法
spoke	说
salute	敬礼
cleaned	清洗
hall	大厅
dawn	黎明
agreement	协议
curiously	好奇
unoccupied	空
waiting	等待
ridicule	调侃
drinks	饮料
seen	看到
doors	门
personnel	人员
wake	唤醒
civil	民事
minute	分钟
displayed	显示
galilee	加利利
whimpered	呜咽
slime	泥
twisted	扭曲
then	然后
sighed	叹了口气
identity	身份
alone	单独
settled	定居
thursday	星期四
column	柱
greatly	大大
babe	宝贝
gasp	喘息
thought	思想
privileges	特权
lie	躺
fictional	虚构
peaceful	和平
unborn	未出生的
shivered	颤抖
provolone	干酪
unsympathetically	冷漠地
leg	腿
throwing	扔
foursome	四人
have	有
when	当
prize	奖
suffer	受
adjoining	毗邻
singed	烧焦的
piled	堆
miss	小姐
belonged	属于
third	第三
advantage	优势
neither	不
misunderstand	误解
swam	游
camp	营
police	警察
tongue	舌
parking	停车
paid	支付
garland	花环
pitifully	可惜
handiwork	手工
suspiciously	可疑
late	晚
contemptuously	轻蔑地
dude	老兄
coffee	咖啡
stimulation	刺激
heavy	重
poetry	诗歌
psychiatrist	精神病医生
framework	框架
aged	岁
sneeringly	轻蔑地
minutes	分钟
frosted	磨砂
neat	整洁
homey	好当家
smirked	傻笑
desperately	拼命
foliage	叶
erase	擦除
engulfed	吞没
apparently	显然
arose	起来
older	老
tone	音
wanting	想要
hatches	舱口
year	年
reprovingly	责备
garment	服装
treasures	宝藏
unappetizing	倒胃口的
traveling	旅行
wherever	无论
der	der
romans	罗马人
relatives	亲戚
egyptians	埃及人
whooshing	呼呼的
pensively	若有所思地
rescue	救援
clutches	离合器
question	问题
builds	建立
ugly	丑
beckoned	示意
relaxing	放松
shotgun	猎枪
beautiful	美丽
this	这
vicked	性恶
collar	领
terribly	非常
uncomfortable	舒服
vit	维生素
afrika	非洲
unable	无法
dere	河
meadows	草地
broiled	烤
flash	闪光
living	生活
agreed	同意
pocket	口袋
immobility	动
channel	通道
glasses	眼镜
bright	亮
conditioning	空调
damp	潮湿
curling	卷曲
confusing	混乱困惑
pays	支付
oz	盎司
safer	安全
stunner	尤物
havana	哈瓦那
ew	EW
multi	多
assembled	组装
ford	福特
bill	比尔
ride	骑
coast	海岸
writhing	扭
electronically	电子
trees	树
chrome	铬
drooped	低垂
jamaican	牙买加
vibrated	振动
sigh	叹息
arness	是
luckily	幸好
unpleasantly	不
last	最后
unkempt	蓬头垢面
level	水平
grew	增长
humor	幽默
porta	门
flay	一气之下
saw	看到
hurtling	疾驰的使用
using	帕洛米诺
palomino	脆
crisp	第二十
muttered	喃喃自语
pockets	口袋
scum	人渣
traditional	传统
create	创建
island	岛
sadistically	虐待狂
armies	军队
hyper	超
protein	蛋白
hated	恨
embarrassedly	尴尬
rome	罗马
deal	处理
faced	面临
bathed	沐浴
televisionland	televisionland
half	半
wood	木
small	小
midgets	侏儒
made	了
resented	对
buried	埋
mask	面具
figure	图
destroy	摧毁
attila	阿提拉
access	访问
downer	唐纳
can	可以
yellow	黄
blasting	爆破
opportunity	机会
filling	填充
head	头
hieroglyphics	象形文字
besides	除了
lord	主
swallow	燕子
scrubby	矮小的
detailed	详细
rastafarians	塔法里教的
machine	机
swarthy	黝黑的
engrossed	全神贯注
proved	证明
sat	坐
galaxy	银河
suitable	适合
twitch	抽搐
guards	警卫
much	多
external	外部
clock	时钟
smugly	自鸣得意的
unhurriedly	不慌不忙
shifted	移
fingers	手指
ring	环
blades	叶片
unwrapped	打开
roofed	屋顶的
wait	等
class	类
clay	粘土
glancing	掠了其
vhich	懒洋洋地躺
lolling	坚持
insistently	旋流
tiny	小
couldn	也
conventional	常规
cap	帽
children	儿童
turned	转身
antennae	天线
reassured	放心
episode	集
nasal	鼻
60	60
complaint	投诉
butter	黄油
commiserated	同情
business	业务
separate	单独
prevent	防止
mistakes	错误
phonographs	留声机
marked	标记
backups	备份
approached	走近
vinyl	乙烯
zat	昭通
pretty	漂亮
nukes	核弹
generation	代
stone	石
motionless	一动不动
labor	劳动
strolling	漫步
cyberslave	cyberslave
position	位置
ninety	九十
liddle	Liddle
gentleman	绅士
sympathize;	同情
hoping	希望
finest	最好的
feathers	羽毛
reason	原因
style	风格
doorframe	门框
fault	故障
mertz	默茨
methodically	有条不紊地
blinked	眨了眨眼睛
odds	赔率
engineering	工程
drawled	慢吞吞地说
travel	旅行
whew	唷
ended	结束
ginger	姜
breeze	微风
genuine	真正
berserk	狂暴
positioned	定位
shopping	购物
yawned	打哈欠
piercing	甲
sneered	冷笑
earlier	早
firewood	柴
excitement	兴奋
said	说
drag	拖
throat	喉咙
soot	烟尘
wiring	布线
visitor	游客
revival	复兴
blocked	封锁
habana	哈瓦那
while	而
parents	父母
arranged	安排
fix	固定
appreciated	赞赏
humid	潮湿
disintegrate	瓦解
latest	新
flustered	慌张又
slid	滑
conferring	授予
double	双
mcdonalds	麦当劳
wooden	木制战车
endless	无尽的
topic	话题
bowed	鞠躬
whistling	呼啸
effort	努力
paying	支付
pooda	pooda
sun	太阳
dreams	梦想
process	过程
never	不
label	标签
offhandedly	顺口
nowadays	如今
by	通过
discovering	发现
hallway	走廊
affectionately	亲切地
sterno	胸
weren	还
zo	ZO
horses	马
character	字符
trips	旅行
rear	后
edged	边
traveler	旅行者
reptile	爬行动物
tolerated	耐受
afore	前
repeating	重复
probing	探测
networking	网络
details	细节
explore	探索
everything	一切
boy	男孩
searched	搜索
grape	葡萄
cake	蛋糕
vays	vays
land	土地
fat	脂肪
statues	雕像
columns	列
payment	支付
scrambled	炒
semi	半
impression	印象
rooms	室
bobbies	警察
something	东西
progressed	进展
vigorously	大力
egypt	埃及
contagious	传染
slit	缝
us	我们
lighting	照明
juicy	多汁
okay	好吧
needs	需要
livid	铁青
edging	边
quiet	安静
stiff	僵硬
number	数
justice	正义
understandingly	宽容地
cannibals	食人族
affecting	影响
sunglasses	太阳镜
cigarette	香烟
horribly	可怕的
knocker	门环
calla	马蹄
ozzie	奥齐
hun	匈奴
least	至少
village	村
audible	可听
instantly	瞬间
season	赛季
concern	关注
activities	活动
abrupt	突然
tomb	墓
substantially	基本
cruise	巡航
trucks	卡车
arrest	逮捕
mock	模拟
dragged	拖
glazed	琉璃
mid	中
dependent	依赖
drip	滴
channels	渠道
limit	极限
balloon	气球
40	40
validated	验证
leads	导致
fields	领域
frowned	皱了皱眉头
uneasily	易
pince	夹
freeway	高速公路
bleat	咩咩
gretel;	葛丽特
vidicom	vidicom
zone	区
barren	贫瘠的
idea	理念
present	目前
officers	人员
uncomfortably	难受
leather	皮革
knob	旋钮
greying	斑白
slapped	打
what	什么
random	随机
patient	病人
sequins	亮片
tune	调
homes	家园
woozy	头昏眼花
shedding	脱落
bear	熊
oppressed	被压迫的
uncaringly	uncaringly
suspicions	怀疑
gruff	粗暴的
front	前
gestures	手势
some	一些
decent	体面的
plan	计划
shall	应
c	C
politely	礼貌地
sounded	听起来
picked	摘
snarled	咆哮着
pressure	压力
gravitational	引力
searching	搜索
straightforwardly	直截了当地瞥了一眼
come	来
forth	四
emphatically	着重
producing	生产
numbers	数
handlebar	车把
direction	方向
hide	隐藏
tellers	出纳员
smaller	较小
parameters	参数
forelegs	前腿
seem	似乎
cheerfully	高高兴兴地
alley	胡同
losses	损失
ago	前
des	DES
cookies	饼干
bizarre	离奇
club	俱乐部
moe	萌
good	好
reassurance	安慰
very	很
telephone	电话
buy	买
mite	螨
asking	问
saturday	星期六
surreal	超现实主义的
dryer	干燥机
lanky	瘦长的
waved	挥手
ditch	沟
straight	直
fears	恐惧
cash	现金
confess	承认
phone	电话
horrendous	可怕的
colors	颜色
strikes	罢工
awkward	尴尬
disaster	灾难
look	看
tink	天衣
aware	知道
weakly	弱
birth	出生
humanoid	仿人
bacon	培根
jar	罐
alto	奥拓
infention	感染
girl	女孩
frank	弗兰克
smile	微笑
dworin	德沃林
leafing	漂浮
leave	离开
awe	敬畏
unlocked	解锁
owe	欠
age	年龄
pointedly	尖锐地
clients	客户
gott	戈特
giant	巨
ann	安
rr	RR
regret	后悔
ve	已经
state	状态
mon	孟
fabulous	神话般的
ethel	埃塞尔
offices	办公室
carnation	康乃馨
coincidence	巧合
struggling	挣扎
two	两
began	开始慢慢
pall	鲍尔
hooves	蹄
excited	兴奋
heaven	天堂
mature	成熟
world;	世界
whatever	无论
securely	安全
future	未来
view	观
counter	计数器
almost	几乎
placenta	胎盘
calmed	平静
uneasy	紧张不安
prince	王子
trapped	困
rounded	圆形
anything	什么
eugene	尤金
groundskeeper	管理员
spitting	吐痰
night	晚上
constructed	构建
applauded	鼓掌
maintain	保持
logic	逻辑
party	党
glow	辉光
tongues	舌头
attempted	试图
amazingly	惊人的
eeyah	eeyah
primitive	原始
bits	位
eaten	吃
pretend	假装
trifle	小事
feigned	假装
obvious	明显
oven	炉
shaped	形
horrified	吓坏了
mists	迷雾
reagan	里根
known	没有人知道
conversational	会话
paused;	暂停
speech	语音
dna	DNA
credit	信用
broadsword	大刀
tan	潭之间
resemblance	相似
greasy	油腻
due	由于
nummer	电话
hours	小时
d0	D0
cars	汽车
hold	持有
dim	昏暗的
meaning	意义
fifteen	十五
anywhere	随时随地
synchronized	同步
wheels	轮
lines	线
happy	快乐
vomit	吐
soon	快
clearly	显然
pitch	间距
recover	恢复
object	对象
ritz	丽思
somehow	不知
over	在
sending	发送
food	食品
spy	间谍
ending	结束
fondue	火锅
contrary	相反
finally	最后
revelry	狂欢
kid	孩子
something;	东西
explain	解释
headhunters	猎头
nightmare	噩梦
dares	敢
precisely	精确
missing	失踪的
cricket	板球
countered	反驳说
annoyance	烦恼
unintelligible	不知所云
overload	过载
subscriber	用户
gasped	喘着气
farms	农场
nearer	近
flood	洪水
wind	风
pointless	毫无意义的
practical	实际
panelled	镶板
operating	操作
trailed	落后
armored	装甲
things	东西
taken	采取
stockings	丝袜
hot	热
noises	噪声
inspecting	检查
cases	例
apart	分开
wonder	奇迹
lived	生活
ominously	不祥
expect	希望
narrow	窄
remnants	残余
general	一般
location	位置
various	各种
order	阶
across	在
crazy	疯狂
swashbuckler	剑客
flinched	退缩
trudged	跋涉
voice	声音
few	几
prim	古板
bleached	漂白
dodge	道奇
has	已经
invisible	无形
daintily	讲究
speaker	扬声器
doorknob	门把
moon	月亮
notes	笔记
original	原
cigars	雪茄
maiden	少女
comment	评论
dummkopf	笨蛋
efening	efening
skimpy	轻薄的
succeeding	成功
halfway	中途
nothing	什么
mess	乱
sensations	感觉
flying	飞
army	军
onion	洋葱
repeated	重复
required	需要
places	地方
brushed	刷
rommel	隆美尔
twenty	二十
equivalent	等效
anyway	无论如何
greatest	最大
peering	窥视
grandmother	祖母
died;	死了
freeze	冻
showed	显示
gradually	逐渐
contagious;	传染
tell	告诉
route	路线
18th	312三第十八
reply	回复
clown	小丑
somebody	人
happen	发生
diminishing	递减
similar	类似
pointed	指出
draw	画
carrying	承载
finds	发现
version	版本
hushed	寂静的
soft	软
inter	间
princess	公主
skulls	头骨
chips	芯片
footwear	鞋类
among	在地平线
plumper	丰满
than	比
receding	后退
afraid	害怕
started	开始
clouds	云
muscles	肌肉
200	200
interrogate	审问
retained	保留
sensed	感觉到
player	球员
powerful	强大的
added	添加
striped	条纹
latin	拉丁
bound	绑定
session	会话
threading	线程
d	D
unpleasant	不愉快的
costumed	盛装的
remarked	说
importantly	重要
enjoy	享受
danger	危险
foolish	愚蠢的
5	5
changed	改变了
invade	入侵
capability	能力
beaming	喜气洋洋的
blanket	毯
selections	选择
burning	燃烧
whale	鲸鱼
hopefully	希望
device	装置
creatures	生物
coy	腼腆的
haul	距离
round	圆
u	U
embarrassment	尴尬
irate	愤怒的
tapped	抽头
vorkplace	vorkplace
disreputable	声名狼藉的
alla	阿拉
connected	连接
aaah	啊
predicament	困境
recovered	恢复
dishevelled	散乱
immediately	立即
p	P
7711	7711
piles	桩
magneto	磁
singled	挑选
seize	抓住
harpsichord	羽管键琴
shtep	shtep
walk	走
refrain;	克制
insult	侮辱
lush	郁郁葱葱的
mascara	睫毛膏
trio	三重奏
cold	冷
askance	斜眼
philosophical	哲学
none	没有
vie	VIE
creak	吱吱
french	法国
travelers	旅客
scintillating	闪烁
today	今天
perfectly	完美的
turkish	土耳其
disposition	配置
camera	相机
count	计数
crack	裂纹
left	左
c)the	C的
path	路径
patience	耐心
goggles	护目镜
peanut	花生
perishable	易腐
line	线
composure	沉着
simply	简单
rejoin	归队
compartment	室
signed;	签署
bell	钟
dirt	污垢
rotated	旋转
tooth	齿
damage	损伤
inch	英寸
screaming	尖叫
worriedly	苦恼
sponsor	赞助商
compared	相比
file	文件
set	集
vay	VAY
illusion	错觉
closet	衣柜
serious	严重
drawn	绘制
servants	仆人
money	钱
pies	派
revolt	反抗
they	他们
hind	后
difficult	难
bandleader	领队
multiple	多
refused	拒绝
continued	继续
renewed	重新
rumbled	隆隆
plunging	暴跌
scraping	刮
6	6
yeeow	yeeow
called	称
solved	解决
cursing	咒骂
wired	有线
lurking	潜伏
through	通过
pens	笔
trenchcoat	风衣
grateful	感激
searchlights	探照灯
wash	洗
perish	灭亡
kids	孩子
confined	局限
government	政府
perplexed	困惑
awful	可怕
proving	证明
fell	下跌
do	做
believable	可信
spreadsheet	表格
kelly	凯利
revised	修订
black	黑
mall	商城
slip	滑
retreat	退
psion	Psion
waste	浪费
sky	天空
disappointedly	失望
sniggered	窃笑
comfortable	舒适
halt	停止
illinois	伊利诺斯
irritatedly	烦
strawberry	草莓
md	MD
dropping	滴
join	加入
spectacular	壮观的
forget	忘记
pulling	拉
solving	解决
beat	击败
not	不
office	办公室
approval	批准
duzzlebuggy	duzzlebuggy
officials	官员
plainly	显然
uncovered	发现
advised	劝
louder	响亮
holding	控股
bag	袋
attitude	态度
assembler	汇编
shtupid	shtupid
generator	发电机
without	没有
rocks	岩
terminates	终止
british	英国
edison	爱迪生
syllable	音节
crop	作物
humming	哼唱
stretch	拉伸
working	工作
alien	外星人
risk	风险
moaning	呻吟
field	场
thunder	雷
accompanying	随行
verse	诗
nazi	纳粹
stereo	立体
wisely	明智
bachelor	学士
smells	气味
obtained	获得
crunch	紧缩
parts	部分
up	起来
raped	强奸
0	0
manager	经理
cliffs	悬崖
paced	节奏
bomb	炸弹
act	行为
distant	遥远的
logo	标志
impossible	可能
stupid	愚蠢的
wondering	想
sensing	传感
see	看到
deafening	震耳欲聋的
careful	小心
unfrozen	解冻
towels	毛巾
seats	座位
quipped	打趣
james	杰姆斯
boom	繁荣
scattered	散
delightedly	欣然
turns	变成
creating	创造
exceed	超过
tiring	累
injuns	例外
aboard	上船
positive	正
fours	四
lock	锁
prepared	准备工作
megaforce	英济
clouded	笼罩地球
rocky	石
affixed	贴
widening	扩大
applause	掌声
100	100
cookie	饼干
busy	忙
alright	好
pharaohs	法老
march	月
motions	运动
longer	更长
dusty	尘土飞扬的
wondered	想
reality	现实
parthians	帕提亚人
seconds	秒
gain	增益
with	与
disfigured	毁容
uproarious	喧嚣的
wish	希望
tedious	乏味的
reassuring	安心
door	门
chopped	切碎
plaster	石膏
shots	镜头
platter	拼盘
yet	然而
flippantly	轻率地
appealing	吸引力
emerald	翡翠
silent;	沉默
comparison	比较
child	孩子
donna	唐娜
ink	油墨
andreas	安德烈亚斯
yelled	大叫
grandfather	祖父
weak	弱
seth	塞思
reaches	达到
trooper	骑兵
speaking	说
liked	喜欢
glare	眩光
exhaled	呼出
sincerely	真诚
aloud	大声
porcelain	瓷
relax	放松
tudor	都铎
lying	躺
insulting	侮辱
press	出版社
received	收到
disgrace	耻辱
cute	可爱
detectives	侦探
unless	除非
sheep	羊
swung	甩
paw	爪
charge	电荷
attracted	吸引
bay	湾
table	表
evasive	回避
plays	扮演着
mannered	礼貌的
pair	对
unum	Unum
escapade	出奔
acoustic	声
trembling	颤抖
exacly	正
cups	杯
wriggled	扭动
several	几
sink	沉
agreeable	惬意的
singles	单打
elvis	埃尔维斯
placed	放置
unarmed	手无寸铁的
agitatedly	勃然大怒
tv	电视
operations	操作
doubtful	可疑
dialed	拨打
protection	保护
bordered	加边
recorded	记录
cards	卡
coupler	耦合器
strains	株
rid	摆脱
decide	决定
elegance	优雅
queasy	动荡的
cray	克雷
own	自己
sunlight	阳光
nein	不
dame	夫人
ll	会
forked	叉
studying	学习
swastika	卍
frantically	疯狂的
ancient	古
father	父亲
hannibal	汉尼拔
da	大
happens	发生
hmmph	hmmph
tend	往往是
streets	街道
changes	变化
enraptured	眉飞色舞
green	绿色
nikto	Nikto
backed	支持
orderly	有序
dis	DIS
avalon	阿瓦隆
helped	帮助
shelf	架
cannibal	食人
uncurled	伸直
civilization	文明
coat	外套
213	213
stella	斯特拉
clones	克隆
anticipation	期待
completely	完全
cakes	蛋糕
fallen	堕落的
quick	快速
hung	挂
victim	受害者
unhappy	不幸
snide	卑鄙的
angle	角
female	女
unmoving	一动不动
loincloth	束带
cents	仙
mowed	修剪
gottverdammter	gottverdammter
bored	无聊
proper	适当
sometime	有时
rococo	洛可可
leaves	叶
pursuits	追求
dr	博士
painted	画
blanks	空白
daily	日常
enter	进入
part	部分
terrible;	可怕
replied	先生回答
flimsy	脆弱
fedora	Fedora
disappointing	令人失望的
demanding	要求
investigate	调查
giddap	快跑
ach	Ach
equipment	设备
illustration	插图
anybody	人
vandalized	破坏
selector	选择器
ridge	岭
stoned	砸死
bunch	束
damaged	损坏
personality	人格
permit	许可
dumbly	默默
rectangular	矩形
beard	胡子
stuff	东西
absent	没有
care	保健
drifted	漂下
ce	CE
funny	有趣的
sniffed	嗅
007c	007c
close	密切
bearings	轴承
israel;	以色列
understand	理解
opens	打开
peculiarly	特别
forefinger	食指
birdsongs	鸟
kinda	点
39	39
nephews	侄子
information	信息
convulsively	抽搐
saucers	碟
happening	发生
prefer	喜欢
troopers	战队
hasty	仓促
animal	动物
impress	打动
chatted	聊
animals	动物
unsure	不确定
disregard	不顾
ear	耳
anciant	古代
hastily	匆匆
nodding	点头
fins	鳍
possibly	可能
durable	耐用
stop	停止
kung	功夫
credits	学分
jungles	丛林
iguana	鬣蜥
chortled	咯咯的笑
satisfactorily	圆满
education	教育
friday	星期五
interrupt	中断
chamber	室
flakes	片
eight	八
veek	星期
capture	捕获
approve	批准
stepped	阶梯
guns	枪
racked	折磨
cheesecake	芝士蛋糕
tent	帐篷
social	社会
effective	有效
spinning	纺
reward	奖励
cockroach	蟑螂
becomes	成为
sit	坐
flintstone	燧石
carving	雕刻
breathed	呼吸
gumg	gumg
improvement	改进
daze	发呆
knew	知道
why	为什么
military	军事
delectable	可喜的
booth	展位
authorization	授权
television	电视
mortal	凡人
aloft	高空
hops	跳
unresponsive	反应迟钝
formed	形成
newer	新
brown	棕色
metal	金属
toasted	烤
pump	泵
maracas	沙球
steep	陡
takes	以
attacks	攻击
classic	经典
whispering	耳语
possible	可能
locations	位置
lighten	减轻
occur	发生
flowing	流动
cool	酷
goodies	糖果
its	其
sarcastically	讽刺地
offered	提供
mixed	混合
marshall	马歇尔
wharf	码头
blared	响起
hadn	还
reveal	揭示
brothers	兄弟
halves	一半
jam	果酱
mistake	错误
exulted	欢腾
wiping	擦
rate	率
sadistic	虐待狂
narrower	窄
resolution	分辨率
shed	棚
tauntingly	嘲弄
placatingly	抚慰
tough	艰难的
smoking	吸烟
into	为
climbed	爬行动
controlled	控制
unconcerned	漠不关心
edition	版
cried	哭
ignoring	忽略
now	现在
flipped	翻转
chronic	慢性
heat	热
jewelry	珠宝
overly	过于
typical	典型
emerged	出现
lapel	翻领
certainly	当然
peeking	偷看
fred	弗莱德
telephones	电话
breath	呼吸
upset	心烦
demanded	要求
strained	紧张
doglike	象狗的
weekends	周末
sniffled	抽噎
desolate	荒凉
rest;	休息
feeble	微弱的
chorus	合唱
2392	2392
discarded	废弃的
better	更好的
accountant	会计
so	所以
fulla	芙拉
mein	我
convenient	方便
bothering	烦
dare	敢
chainsaw	电锯
spotted	发现
alive	活着
china	中国
fry	炒
trench	沟
indeed	的确
bricks	砖
gretel	葛丽特
trays	托盘
reappeared	再现
law	法律
finality	终结
force	力
raincoat	雨衣
particularly	特别
dime	毛钱
armor	装甲
dinosaurs	恐龙
agreeably	欣然
cloud	云
christmas	圣诞
boring	无聊
noisily	大声唱
enclosed	封闭
bald	秃
utensils	用具
databases	数据库
attacked	攻击
chuckled	笑
sand	砂
mi	MI
despondently	沮丧地
bend	弯曲
astaire	阿斯泰尔
hawaii	夏威夷
brats	小子
popped	突然
down;	下来
sinking	下沉
flight	飞行
pizzas	披萨
perusing	阅读
contestants	选手
lined	内衬
hits	打
slots	槽
digging	挖
labyrinth	迷宫
precious	珍贵
junk	垃圾
gleefully	兴高采烈地
virgin	处女
torches	火把
universe	宇宙
punk	朋克
jackboots	长筒靴
absently	心不在焉地
house	房子
sooner	早
discovers	发现
biggie	Biggie
morning	早上
bounced	反弹
legs	腿
involved	参与
sadly	可悲的是
rocking	摇摆
defended	辩护的东西
robot	机器人
bong	奉
city	市
divulge	透露
frown	皱眉
descending	降
compulsively	强制
from	从
marble	大理石
account	帐户
deeply	深入
starting	开始
pitched	坡
fail	失败
favorite	最喜欢的
beeped	呼
startle	惊吓
grip	握
backstage	后台
tossed	扔
twelve	十二
thoughfully	考虑周到
certainty	确定性
alarm	报警
chuck	卡盘
forbidding	禁止
meringue	酥皮
9150	9150
enormously	极大
tabs	标签
runner	转轮
cream	霜
poisoned	中毒
fires	火灾
hapless	倒霉的
tied	绑
grinned	咧嘴一笑
others	别人
grazing	放牧
bypass	旁路
excellent	优秀的
agent	剂
sweat	汗
tender	招标
layers	层
western	西方
guy	家伙
seam	缝
forced	强迫
sickening	令人作呕
huns	匈奴
pained	痛苦
doggerel	打油诗
strongly	强烈
onto	到
shtart	shtart
sixty	六十
thrown	扔
chop	砍
feeds	饲料
prowling	在画面表现
thousands	成千上万
agreeing	同意
cares	关心
tres	三
didn	也
majestic	雄伟的
equal	相等
volume	体积
elegant	优雅
department	部
basic	基本
wailers	哭丧者
awkwardly	笨拙地
uncomprehendingly	不解地
ross	罗斯
placental	胎盘
returned	返回
snapping	抢购
pip	PIP
crashed	坠毁
curve	曲线
shrugged	耸了耸肩
barbara	巴巴拉
hawaiian	夏威夷
demurred	反对
barked	吠叫
crowding	拥挤
surroundings	环境
easier	容易
woof	汪
knee	膝
yeah	是
fashioned	老式
pop	流行
hiya	你好
quivered	抖动
lives	生活
below	下面
yard	院子
starts	开始
hissed	嘶嘶
society	社会
945	945
copying	复制
enlarged	扩大
owners	业主
turning	转折
dese	这些
milled	磨
protested	抗议
rough	粗糙
pondered	思考
cry	哭
wisps	缕缕
dogs	狗
an	一
system	系统
trivets	铁架
causes	原因
upright	直立
issue	问题
orbit	轨道
cocked	竖起
reptiles	爬行动物
guide	引导
apologized	道歉
rated	额定
dot	点
wrote	写
refinement	细化
antimatter	反物质
wizards	奇才
federal	联邦
voucher	凭证
gestapo	盖世太保
vanished	消失
rules	规则
baby	宝贝
villa	别墅
vienna	维也纳
pumping	抽
straw	秸秆
snapped	抢购
distressingly	令人
bravo	布拉沃
man	人
assurance	保证
taxi	出租车
brushing	刷
host	主机
jovially	快活
strike	罢工
mammals	哺乳动物
remedied	补救
incident	事件
substance	物质
stumbling	绊脚石
bouncing	弹跳
swayed	动摇
feet	脚
realities	现实
stared	盯着
lunacy	疯狂
end	端
everybody	大家
splintered	分裂
framisttater	framisttater
gittin	昨天
yesterday	怪异了
immortal	不朽的
word	字
embarked	走
suffering	痛苦
wings	翅膀
villages	坑村
glowingly	畅谈
afternoon	下午
gates	盖茨
ticket	票
if	如果
unrecovered	恢复
dismally	惨淡经营着
organizes	组织
lowered	降低
losing	失去
legible	清晰
whirled	旋转
glumly	闷闷不乐地
per	每
intently	目不转睛地
morsels	佳肴
muffled	低沉的
valley	谷
twirling	捻
horselike	马
sternly	严厉
directory	目录
band	带
hollywood	好莱坞
guys	家伙
threw	扔
unrelated	无关
feasting	宴饮
picturesque	如画
wear	穿
giggling	咯咯地笑
crumpled	皱巴巴的
heaps	堆
stump	树桩
month	月
uncontrollably	失控
adapted	改编
experience	经验
fitting	拟合
straightened	直
whenever	每当
golden	金
flirt	调情
manning	曼宁
hoped	希望
sides	两侧
triplicate	三
phrase	短语
oblivious	遗忘
tears	眼泪
first	第一
bringing	带来
moving	移动
consideration	考虑
miserable	悲惨的
fifty	五十
fits	适合
roll	辊
clearing	结算
acting	2代
tabloids	小报
neck	颈
burns	烧伤
depressing	郁闷
psychiatry	精神病学
bob	鲍勃
believe	相信
slave	奴隶
disagreeable	讨厌的
daughter	女儿
super	超级
world	世界
distantly	遥遥
paging	寻呼挫败
thwarted	侦察
scout	TEM
tem	城市
remind	提醒
please	请
hundreds	数百
having	具有
reptilian	爬虫
tight	紧
doin	做
flung	扔
boop	BOOP
sharp	锋利
lash	睫毛
brand	品牌
7391	7391
silly	傻
laughter	笑声
cardiac	心脏
fun	乐趣
assumes	假定
brittle	脆
picket	纠察
intended	有意者
itch	痒
people	人
bolt	螺栓
lit	点燃
leggings	护腿
circle	圈
lashed	抨击
impossibly	不可思议
carriers	运营商
discard	丢弃
sitting	坐
particular	特别
receiver	接收机
maliciously	恶意
staff	员工
those	那些
fu	福
1957	1957
allowing	让自己的婚姻
passed	通过
contemplatively	沉思
cape	海角
greeted	迎接
insignia	徽章
fruit	水果
stumps	树桩
omaha	奥马哈
going	去
shu	舒
sector	部门
warranty	保修
horrible	可怕的
fair	公平
amazed	惊讶
keel	龙骨
studs	钉
especially	特别是
documents	文件
yarf	yarf
tiresome	烦人的
shouted	喊
shiny	闪亮的
gumby	Gumby
winced	畏缩
dale	戴尔
hire	雇用
knocking	敲
bavarian	巴伐利亚
sideways	侧身
stranger	陌生人
bewildered	困惑
harm	危害
briskly	轻快
lee	李
destroys	破坏
dillon	狄龙
perched	栖息
enraged	激怒
fronts	锋无力
scalp	头皮
mission	使命
because	因为
development	发展
crossed	交叉
don	不
reasonably	合理
preserve	保存
warm	温暖
chewing	咀嚼
snickered	窃笑
42	42
falling	落
backs	背
goes	去
saying	说
introduce	介绍
dance	舞蹈
julius	尤利乌斯
peach	桃
score	评分
wet	湿
measureless	无限
boys	男孩
examples	实例
congratulations	祝贺
creepy	令人毛骨悚然的
california	加利福尼亚
hope	希望
ees	EES
thrashed	痛打
makeup	化妆
partes	部分
balefully	恶意
sleep	睡眠
wooly	毛茸茸的
sipping	喝
lookit	看
sprang	跳
kill	杀
lights	灯
conversationally	交谈
resounding	响亮的
occasional	偶尔
teller	取款
gloat	幸灾乐祸
announcer	播音员
puppy	小狗
na	Na
approvingly	赞许
ruler	尺
tracks	轨道
palo	帕洛
events	事件
acute	急性准备
unhand	放开
rapidly	迅速
east	东
balance	平衡
stammered	结结巴巴地说
erupted	爆发
sniffing	嗅闻
25)	25
biff	比夫
bop	国际收支
piped	管道
buying	购买
signs	标志
falls	瀑布
factly	地
shoulda	应该
accident	事故
gulped	哽住了
rank	秩
foul	犯规
disagreed	不同意
corkscrew	螺旋
surrounding	周围
transported	运
barney	巴尼
yukon	育空
dat	DAT
girlfriends	女友
stomping	跺脚
indignant	愤怒的
originally	原本
out;	出来
vell	好
toys	玩具
creeping	匍匐
fool	傻瓜
finished	完成
circumstances	情况
confidently	自信
herded	在
fiction	小说
apply	申请
expectantly	期待
stack	栈
shouldn	应该
drawers	抽屉
hustling	熙
neared	接近
beefy	结实
doktor	博士
single	单
lead	铅
realistic	现实
still	仍然
flicking	闪烁摇摇欲坠的
permission	说
get	得到许可
wizard	向导
tree	树
ferociously	恶狠狠地
flicka	弗莉卡
problem	问题
standard	标准
turn	转
well	好
counts	计数
brink	边缘
rights	权利
jaw	颚
tought	教
real	房
answer	回答
assured	放心
smoldering	阴燃
stay	呆
thirty	三十
listens	听
ruffled	竖起
unlike	不像
matches	比赛
discarding	丢弃
50	50
irritated	烦
english	英语
parted	分手
heston	赫斯顿
wholesome	有益健康
masses	群众
leaving	离开
seat	座
lips	嘴唇
vague	模糊
choking	窒息
minimum	最小
wot	WOT
vhen	当
star	星
grounds	理由
bartender	酒保
celebrity	名人
beers	啤酒
closely	密切
7	7
abilities	能力
leaning	学习
twiddling	玩弄
ours	我们
size	大小
sandals	凉鞋
jack	杰克
3451	3451
suspicious	可疑
drive	驱动
heck	见鬼
mind	心
evilly	邪
holes	孔
alps	阿尔卑斯
neatness	整洁
joe	乔
ow	OW
following	以下
rags	破布
unpaid	无偿
effects	影响
disappointment	失望
gruyere	格吕耶尔
themselves	自己
gracelessly	gracelessly
taste	味道
intoned	吟诵
staring	凝视
closer	接近
chasing	追逐
bureaucracy	官僚
gazing	凝视
moved	感动
hook	钩
stairway	楼梯
maneuvered)	机动
dances	舞蹈
craziness	疯狂
records	记录
sectors	部门
sam	山姆
talk	谈
interior	内部
disconcertedly	惊慌地
accent	口音
disguise	伪装
glared	怒视着
thudded	摔
swimming	游泳
ground	地面
filled	填充
barely	几乎瘫痪
expense	费用
413	413
transport	运输
buddy	好友
selected	选择
corridor	走廊
tiptoed	踮着脚尖
drinking	饮用
girlfriend	女友
threesome	3P
efen	该
decibels	分贝
asleep	睡着了
killed	杀
company	公司
heavens	天堂
representatives	代表
instructions	指令
cuban	古巴
women	妇女
annoyed	生气
plant	植物
sour	酸
utterly	完全
ahem	咳咳
voiced	表示
defensive	防守
further	进一步
ordering	订购
match	匹配
womb	子宫
millions	数百万
giving	给
becoming	成为
slabs	板
nodded	点头
iguanas	鬣蜥
meet	满足
impatient	不耐烦
eyeliner	眼线
escape	逃避
customarily	通常
published	发表
payments	支付
colby	科尔比
monocle	眼镜
instinctively	本能地
need	需要
statement	声明
aging	老化
stand	站
confusedly	迷茫
stretching	拉伸
comedies	喜剧
sea	海
yogurt	酸奶
bye	再见
game	游戏
692a	692a
disconcerting	令人不安
1960	1960
vacuuming	吸尘
fired	解雇
dining	餐饮
contents	内容
indeterminate	定
radioactive	放射性
characters	人物
pants	裤子
dubbed	配音
vhat	什么
missing)	失踪
comin	今儿
sunset	日落
landing	着陆
uttered	发出
headed	为首的
pc	PC
chops	排骨
decanter	滗水器
rumors	传闻
poland	波兰
did	做
intense	激烈
lawrence	劳伦斯
dating	约会
limp	跛行
hearts	心
grey	灰色
fingering	指法
collection	收集
calmly	从容
flower	闪烁其词的花
totally	完全
announcement	公告
pushbuttons	按钮
thing	事
ratio	比
equivalents	等价物
stands	站
opposite	相反的
loved	爱
fur	毛皮
dignity	尊严
gimme	给我
course	课程
drawing	绘图
hi	嗨
choked	哽咽
reins	缰绳
prospect	前景
audience	观众
vanted	着
strings	字符串
viewers	观众
heating	加热
unbelievable	难以置信的
breaking	打破
dark	黑暗
shout	喊
synthesize	合成
expecting	期待
weekly	每周
guard	警卫
scrumptious	美味
minus	减
pallid	苍白的
reich	帝国
cheered	欢呼
abilene	阿比林
sgt	SGT
lay	躺
reminded	提醒
held	举行
thundered	大声疾呼
ernie	厄尼
gotta	得
awesome	真棒
encouraged	鼓励
beluga	白鲸
stays	停留
palm	棕榈
swift	迅速
mounting	安装
israel	以色列
terrible	可怕的
quaint	古雅
request	请求
each	每
expounded	阐述了
traffic	交通
worst	糟糕的
accusing	指责
encountered	遇到
him	他
sweep	扫
all	所有
mars	火星
love	爱
service	服务
figures	数字
country	国
darkness	黑暗
kindly	请
beds	床
gully	沟
realization	实现
listings	房源
electronic	电子
garbage	垃圾
convoy	车队
vanishing	消失
blond	金发
fall	落
vehicle	车辆
played	打
cigar	雪茄
checkpoints	检查站
found	发现
beer	啤酒
afford	起
wringing	绞
charlton	查尔顿
watched	看着
efficient	高效
expected	预期
hunger	饥饿
57	57
handkerchief	手帕
verified	验证
recommend	推荐
however	然而
attendant	服务员
shattering	粉碎
ecstatic	欣喜若狂
corrected	纠正
matched	匹配
howdy	你好
glowered	怒目而视
quietly	静静地
ringing	响
or;	或
structure	结构
over;	结束
sulked	怄气
flesh	肉
sensation	感觉
1193	1193
jabbed	戳
bring	带上
rolaids	Rolaids
glue	胶
detached	分离
underbrush	丛林
ooh	哦
roomy	宽敞的
light	光
seiko	精工
ordinary	普通
torch	火炬
swan	天鹅
suburban	郊区
amazement	惊愕
reached	达到
ein	EIN
moron	白痴
sounding	测深
institution	机构
chain	链
these	这些
skeptical	怀疑
problems	问题
preston	普雷斯顿
116	116
muffiedump	muffiedump
vith	维特
balding	秃顶
flanked	两侧
content	内容
give	给
water	水
wailed	嚎啕大哭
enjoyed	享受
21	21
asks	问
recently	最近
pardon	原谅
zis	ZIS
could	可以
appetite	食欲
lone	孤
amount	量
listening	听
beyond	超越
filed	提起
shoved	推
starve	饿死
everyone	大家
remember	记得
laguardia	拉瓜迪亚
huffily	生气地大声
worse	糟
tanks	坦克
metropolitan	都市
stations	站
silently	默默
000	000
dancing	跳舞
cows	奶牛
moments	时刻
moses	摩西
overdue	逾期
income	收入
organize	组织
watch	看
broke	打破
apartment	公寓
theme	主题
satisfied	满意
oak	橡木
imagining	想象
run	运行
seller	卖方
impressed	印象深刻
pronounced	明显
interrupting	打断
maintained	保持
instruction	教学
greek	希腊
settings	设置
absolutely	绝对地叫
hex	六
shortage	短缺
neatly	整齐
4729	4729
vegas	拉斯维加斯
computers	电脑
stomped	踩
nuttin	尼坦
avoiding	避免
offense	进攻
pageant	选美
math	数学
howya	howya
rudely	粗鲁
48429	48429
independently	独立
disguised	变相
century	世纪
horse	马
chairs	椅子
awoke	醒来
drooling	流口水
might	可能
locks	锁
elephant	大象
respect	尊重
does	确实
mass	质量
midget	侏儒
situation	情况
cops	警察
piece	片
reaching	达到
lucy	露西
sunk	沉没
bambi	小鹿斑比
introduction	介绍
are	是
fragile	脆弱
story	故事
candelabras	烛台
regard	把
readjust	调整
swirled	打旋
crag	岩
himself;	自己
hitched	拴
melting	熔化
guffawed	大笑
snoring	打鼾
canine	犬
spoiling	溺爱
yodellay	yodellay
consented	同意
gridlock	僵局
dem	DEM
manufacturer	制造商
become	成为
welcome	欢迎
aha	AHA
easy	容易
actors	演员
ones	的
gesturing	手势
eat	吃
naw	瑙
date	日期
techno	技术
yo	哟
tables	表
evil	邪恶
wonderful	精彩
our	我们
vasn	vasn
little	小
jubilant	欢腾的
cleared	清除
dragging	拖
thuds	声
angrily	愤怒地
dirndl	紧身
building	建筑
ouph	恶人
shareware	共享
groomed	培训的
impolite	礼貌
nothin	nothin
floor	地板
cherries	樱桃
lapels	翻领
vhy	VHY
drums	鼓
baa	咩
somevhere	somevhere
genius	天才
cast	铸
statue	雕像
chure	chure
consists	由
sizzling	铁板
generally	一般
jungle	丛林
serial	串行
remittance	汇款
cup	杯
organized	组织
running	运行
arcades;	拱廊
towel	毛巾
finish	完成
yea	是
slowed	放缓
warmly	热忱
jacket	夹克
outstanding	优秀的
thin	薄
computing	计算
notepad	记事本
secret	秘密
hur	HuR
other	其他
biz	商务
relaxed	轻松
toto	TOTO
stuck	在
west	西
1978	1978
rastas	塔法里教的
neon	霓虹
battle	战斗
sparkling	闪闪发光的
bottle	瓶
ray	射线
shoulder	肩
critically	批判
rising	上升
deserts	沙漠
dimension	维
mounted	安装
scenery	风景
geography	地理
decisively	果断
shut	关
conclusion	结论
meadow	草甸
communications	通信
twitched	抽搐
hooked	钩
told	告诉
clean	清洁
islands	群岛
sad	伤心
knowingly	明知
mane	鬃毛
mothballs	樟脑丸
commanded	吩咐
meanwhile	同时
accept	接受
childlike	孩子气的
reluctantly	勉强
warp	经
tell;	告诉
allowances	津贴
bit	点
offended	得罪了
victims	受害者
hundred	百
searchingly	地
feel	感到
she	她
waiter	服务员
pad	垫
elbowed	挤
repetitious	重复
reach	达到
heap	堆
burn	烧伤
marsch	进行曲
brother	兄弟
record	记录
steadfastly	坚决
bites	咬
vaste	vaste
hideous	可怕
five	五
boot	启动
grind	磨
drooping	下垂
riveted	铆接
raised	提出
automatically	自动
rummage	翻找
commercial	商业
mother	母亲
cyberslaves	cyberslaves
fifties	50
de	de
echoed	回荡
scary	可怕的
chester	切斯特
drawling	慢吞吞的
unprotected	保护
thrilled	激动
containers	容器
walking	走
systems	系统
pete	皮特
inhabited	居住
paint	漆
done	做
how	如何
pull	拉
hurling	投掷
liederkranz	利德克兰兹
mystified	迷惑
four	四
cheaply	便宜
alarmed	惊慌
hosts	主机
sized	大小的
after	后
areas	地区
realize	实现
precluding	排除
vitch	微姿
family	家庭
identifiable	识别
ran	跑
twice	两
trunk	躯干
disappear	消失
reasonable	合理
frightening	可怕的
deep	深
perturbed	摄动
survive	生存
aimed	瞄准
awright	好
flew	飞
constantly	不断
calculatingly	计算
galloped	疾驰
eliminate	消除
exclamation	感叹
vault	拱顶
joker	小丑
titanic	泰坦尼克号
verification	验证
geology	地质
track	轨道
ulcer	溃疡
vot	VOT
many	许多
hill	山
undergrowth	林下
misshapen	畸形
reported	报道
sorrowfully	悲哀
soap	肥皂
importance	重要性
greatness	伟大
gesticulating	指手画脚
buildings	建筑
captives	俘虏
hurriedly	赶紧
yourself	自己
millennia	千年
kin	健
toe	趾
idiot	白痴
pages	页
clutching	紧抓
treasure	宝
eiffel	艾菲尔
let	让
discussing	讨论
peered	凝视
toledo	托莱多
scarecrow	稻草人
serves	服务
whoa	哇
want	想
jumping	跳
convinced	说服
sir	先生
cut	切
slipped	溜
football	足球
flames	火焰
bottomless	无底洞
shuts	关
durand	杜兰德
dramatically	大大
smeared	涂抹
murphy	墨菲
grows	生长
rolled	滚
leash	皮带
esc	ESC
frenchman	法国人
enthusiastic	热情
cia	CIA
increasing	增加
remotely	远程
somewhere	在
proof	证明
announced	宣布
struggle	斗争
sailing	帆船
truth	真理
weaving	织造
surely	肯定
thoughts	思想
coded	编码
riot	防暴
ad	广告
experiencing	经历
magazine	杂志
young	年轻
questioning	提问
kick	踢
affairs	事务
speak	说
grow	成长
accused	被告
sense	感
nonchalant	漠不关心
flexible	柔性
successful	成功
know	知道
wrapping	包装
complaining	抱怨
hello	你好
interrogation	讯问
ii	二
agents	剂
cleaning	清洗
trail;	踪迹
deserted	冷清
oddly	奇怪的
electricity	电
waving	挥舞
retrieve	检索
feelings	感情
eh	嗯
luxurious	豪华
indignation	愤慨
arrested	逮捕
ben	本
messenger	信使
call	叫
science	科学
cowboy	牛仔
think	认为
switch	开关
hesitate	犹豫
wanna	想
dunnit	做
go	去
considerably	相当
puzzlement	困惑
jumped	跳
safest	安全
terminate	终止
patio	天井
main	主要
discussion	讨论
snake	蛇
rivers	河流
dejectedly	沮丧地
message	消息
adjust	调整
relatively	相对
verses	诗句
books	本书
remembered	记得
swim	游泳
carramba	carramba
articles	文章
custard	蛋奶冻
orange	橙
bark	树皮
ingenuously	率直地
staggered	交错
d)how	d如何
occupied	占领
god	神
arnaz	阿纳兹
concentration	浓度
drifting	漂流
ah	啊
completion	完成
urged	敦促
settles	落定
metallic	金属
powered	动力
collapsed	倒塌
awake	清醒
reared	饲养
cosmetics	化妆品
titled	题为
chariots	战车
tearing	撕裂
gladiator	斗士
paper	论文
aback	大吃一惊
bovine	牛
peer	同行
insurance	保险
ya	雅
trying	尝试
bed	床
inevitable	必然
geometric	几何
spare	备用
pharaoh	法老
dabba	美好
incredible	难以置信的
sign	标志
victrola	留声机
arched	拱形
ss	SS
october	十月
ridiculous	可笑
wicked	邪恶的
final	最终
ever	曾经
glory	荣耀
shape	形状
bridle	缰绳
humpback	驼背
cajoled	哄骗
sudden	突然
riding	骑
heavenward	天空
superior	优于人工
dubiously	半信半疑地责备
tower	塔
gross	毛
clowns	小丑
dreadlocks	辫子
destruction	破坏
return	返回
lamb	羊肉
awfully	非常
conscious	意识
hinges	铰链
points	点
disappoint	失望
butts	烟头
sue	苏
envelope	信封
receptionist	接待员
find	找到
b	B
papers	论文
pity	怜悯
kept	保持
ushered	迎来
one	不当一
shtarted	shtarted
down	下
cheerleaders	啦啦队
underneath	下面
total	总
thataway	朝那个方向
early	早期
commands	命令
consisting	组成
facility	设施
whimper	呜咽
blocking	阻塞
stood	站
reporter	记者
expression	表达
groused	抱怨
dry	干
step	步
mustache	胡子
schools	学校
gurgling	潺潺
incompetence	无能
gallia	高卢
risen	上升
amnesia	失忆
distressed	心疼
refilling	回填
tightened	收紧
die	死了
heil	万岁
cautioned	警告
pie	派
severe	严重
marginally	轻微
alternative	替代
somethin	什么
shaking	摇
performers	表演者
atrium	心房
uncomprehending	不解
improving	提高
towing	拖
bogus	假
mysteries	奥秘
evilly;	邪恶
went	去
apprehensively	悬念
prompted	促使
attempting	尝试
stool	凳
shtill	shtill
pitiless	无情的
gee	哎呀
moaned	呻吟
seventies	七十
cruisin	Cruisin
dish	菜
hat	帽子
shouts	喊
institutions	机构
overlooking	俯瞰
wandered	徘徊
color	颜色
toad	蟾蜍
hysterically	歇斯底里地
arms	武器
pale	苍白
zero	零
supposed	应该
enthuse	热心
indignantly	愤怒的
callously	无情地
plus	加
animatedly	活生生地
jubilee	禧
mommy	妈妈
architecture	建筑
ricardo	李嘉图
selection	选择
stole	偷走了
narrowed	缩小
construction	建设
although	虽然
wry	苦笑
vegetables	蔬菜
confident	自信
continuously	不断
tipped	尖
greater	大
und	und
paranoids	偏执狂
trail	TRAIL
empty	空
consulted	咨询
altogether	共
t	T
data	数据
stark	斯塔克
foods	食品
leap	飞跃
natives	当地人
unpaved	铺
incontrovertible	无可争议的
quality	质量
bruce	布鲁斯
radiating	散热
travelling	旅行
therefore	因此
mild	轻度
essay	论文
solution	解
understood	理解
curtains	窗帘
patches	补丁
painfully	痛苦
herr	先生
grab	抢
weapons	武器
slightly	稍
sifting	筛选
landscape	景观
menacingly	来势汹汹
forty	四十
mighty	强大的
establishes	建立
board	板
wardrobe	衣柜
starring	主演
unbroken	完整归档
sinuses	窦
value	价值
cruel	残酷的
model	模型
broken	破
logical	逻辑
momentarily	随时
schweinhund	schweinhund
pleased	高兴
rhythmically	节奏
beneath	在
zey	他们
same	同
confirmed	证实
lap	圈
confused	困惑
cloth	布
detective	侦探
impersonators	模仿
full	全
galloping	舞动
galaxies	星系
popsicles	冰棍
someone	人
vista	Vista
idyllic	田园
production	生产
witch	女巫
lamented	感叹
insect	昆虫
o	O
dear	亲爱的
frug	弗鲁克
yawning	打哈欠
gunsels	gunsels
on)	上
thick	厚
identify	识别
frappe	冰沙
strenuous	剧烈
surrounded	周围
stressful	压力
severely	严重
decided	决定
achy	疼痛
remained	仍然
unit;	单元
dense	密集
weapon	武器
tiptoeing	脚尖
vill	必须
came	来
side	侧
copy	复制
cornfield	麦田
occasion	场合
x	X
unmovable	不可动摇的
fetching	取
spears	矛
normal	正常
network	网络
loosen	松开
fill	填补
which	这
shimmer	微光
bismol	碱式水杨酸铋
sleazy	肮脏的
getting	得到
print	打印
headline	标题
interested	感兴趣
matt	马特
sword	剑
portly	大腹便便的
proclaimed	宣布
sugar	糖
utilitarian	功利
sunburn	晒伤
cracks	裂缝
wha	什么
person	人
jerk	混蛋
blaster	霸
idiots	白痴
invasion	入侵
poodawumpus	poodawumpus
freezer	冰箱
rapturously	欢天喜地
probably	可能
warily	小心翼翼地
snatched	抢走
chances	机会
pompously	傲慢地
bobby	鲍比
tangled	纠结
hearing	听力
right	右拇指轻轻
time;	尽管时间
stifle	扼杀
boulders	巨石
spacecraft	航天器
sheaf	捆
handling	处理
cross	交叉
nailed	钉
dinosaur	恐龙
pushed	推
unsupported	支持
prehistoric	史前
blue	蓝
inspected	检查
grimaced	扮了个鬼脸
shuddered	战栗
affair	事件
traitor	叛徒
naked	裸体
clopping	正指向
beret	贝雷帽
subsided	消退
judy	朱迪
grumbling	抱怨
existent	存在
supply	供应
disks	磁盘
shattered	粉碎
beverages	饮料
stuffing	馅
buttons	按钮
stepping	步进
blackness	黑度
later	后来
murdered	谋杀
explained	解释
favor	青睐
times	倍
teacher	老师
carried	进行
manure	肥
leaned	靠
majesty	陛下
streaked	条纹
odes	赋
hour	小时
clapping	鼓掌
hid	藏
responsibility	责任
package	包
opened	打开
tore	撕
ease	缓解
noisy	嘈杂的
divisio	分裂
take	采取
composed	组成
at	在
simplified	简化
rummaging	翻找
heavily	重
nobleman	贵族
tvs	电视
nearest	最近
uses	使用
shocked	震惊
cooler	冷却器
screamed	尖叫
names	名称
chicago	芝加哥
iowa	爱荷华
more	更
astonished	惊讶
arcade	街机
screams	尖叫
killer	杀手
inches	英寸
grace	恩典
stress	应力
sacred	神圣
saver	保护
ay	AY
fatal	致命的
lady	女士
bodies	体
plymouth	普利茅斯
atomic	原子
prisoner	囚犯
layer	层
free	自由
burly	魁梧的
either	要么
yer	你
parked	停
items	项目
against	对
worked	工作
brassy	黄铜色
casting	铸造
air	空气
unto	对
blueberry	蓝莓
friends	朋友
comic	漫画
fumed	熏
bobbing	摆动
sturmbannfuhrer	sturmbannfuhrer
stage	阶段
awaiting	等待
tie	领带
secrets	秘密
twist	捻
counseling	咨询
crank	曲柄
highway	公路
timidly	胆怯地
00	00
entered	进入
perfection	完善
steal	偷
carpet	地毯
mousse	慕斯
cover	盖
before	之前
flame	火焰
markings	标记
stars	明星
approximately	约
nanoseconds	纳秒
screwed	拧
ricky	瑞奇
handful	少数
cm	厘米
circus	马戏团
reading	阅读
add	添加
fancy	花式
ominous	不祥
squinted	眯起眼睛
leak	泄漏
alpine	高山
autobahn	高速公路
urgently	迫切
renewal	更新
patton	巴顿
sands	金沙
passages	通道
infernal	地狱
dampness	湿
wave	波
hurrying	匆匆
pictures	图片
difference	差
heh	呵
database	数据库
collector	收集器
lucky	幸运
gone	离去
grins	笑
park	公园
israelites	以色列人
tearfully	含泪
array	阵列
hinted	暗示
panic	恐慌
familiar	熟悉
chair	椅
compassionately	同情
entire	整个
edge	边缘
bothered	打扰
tires	轮胎
corner	角
hoo	呼
diligently	努力
suspended	悬浮
group	组
disc	盘
pepto	要
grain	粮食
larva	幼虫
tomatoes	西红柿
bumper	保险杠
padlock	挂锁
grunted	哼了一声
examining	检查
quark	夸克
curls	卷发
street	街
brain	脑
sleeves	袖子
song	歌
differently	不同
disappeared	消失
proceeded	进行
escorted	护送
supermarket	超市
ja	JA
upside	上
youse	你们
chiffons	花边
orchestral	管弦
mc	MC
sister	姐姐
whirling	旋转
harem	后宫
arrow	箭
hear	听到
throne	宝座
busily	忙
pet	宠物
75	75
innocently	傻傻地
implored	恳求
cheerio	再见
performing	表演
brundage	布伦戴奇
tank	罐
likely	可能
purchase	附近购买
fork	叉
ravenously	狼吞虎咽
expansively	扩展
interstellar	星际
also	也
pointy	尖尖的
uncool	酷
subdued	柔和的
slight	轻微
enterprise	企业
lotta	洛塔
preened	打扮
dungeon	地牢
rca	RCA
costumes	服饰
forfeit	丧失
informed	知情
fireflies	萤火虫
overtime	加班
cheese	奶酪
midst	中间
nowhere	处
beats	节拍
hole	孔
bank	银行
hurt	伤害
annette	安妮特
magnificence	辉煌
ornamental	观赏
wrap	包
pavement	路面
fortune	财富
vorse	沃尔斯
rummaged	翻了
load	负荷
sys	系统
continue	继续
recorder	录音机
egad	天
obviously	显然
soldier	士兵
possibility	可能性
station	站
stroked	抚摸
approaching	接近
success	成功
readjustment	调整
edges	边
n	N
aaugghh	aaugghh
aren	是
endlessly	不休
styles	款式
gum	胶
bar	酒吧
produced	产生
scheme	方案
epidemic	流行
life	生活
determined	确定
attack	攻击
mentioned	提到
sniping	狙击
whoever	谁
zere	零
heidi	海蒂
item	项目
vaiting	vaiting
teenage	青少年
translated	翻译
proud	自豪
boil	煮
served	担任
stung	蜇
forties	四十
side;	侧
didja	啊
defensively	防守
hesitant	犹豫
carpeted	地毯
bones	骨头
mirrors	镜
infinitely	无限
poisonberry	poisonberry
vaguest	模糊地
massacre	大屠杀
maker	制造商
reclining	斜倚
leader	领袖
lost	失去
drink	喝
vegetation	植被
revenge	复仇
anytime	随时
testing	测试
realized	实现
ganja	大麻
consulting	咨询
yards	码
shirt	衬衫
ceiling	吸
16	16
forward	向前
shields	盾牌
dozen	打
materials	材料
rushed	冲
swiss	瑞士
sorta	点
queens	皇后
built	建
foreign	外国
pediment	山花
dreadfully	可怕的
zany	滑稽
dismal	惨淡
vast	绝
doubt	怀疑
crash	崩溃
annoyedly	懊恼
feed	饲料
primeval	原始
judges	法官
threatening	威胁
sick	生病
potatoes	土豆
wonderingly	好奇地
years	年
limo	轿车
shrivelled	干瘪的
shooting	拍摄
flourish	蓬勃发展
outfits	服装
curly	卷曲的
personally	个人魅力
costume	服装
space	空间
exact	精确
colonel	上校
watering	浇水
programs	程序
klaatu	Klaatu
veapon	veapon
pressed	压
thanks	谢谢
series	系列
indifferently	漠然
burst	突发
togas	气
grapes	葡萄
fools	傻瓜
resumed	恢复
talking	说
stops	停止
rumbling	隆隆
wife	希特勒的妻子
galactic	银河
invaded	入侵
happily	幸福
discs	盘
inched	小幅
holger	霍格尔
gloating	幸灾乐祸的
rin	凛
traumatic	外伤性
amber	琥珀
tentacles	触角
smoked	熏
accordions	手风琴
crowd	人群
chasm	鸿沟
meter	米
creeps	爬
overstuffed	软垫
quickly	很快
boarded	登上
nine	九
assuredly	无疑
knows	知道
grass	草
thorn	刺
psoriasis	银屑病
folks	乡亲
flicked	弹
tall	高
response	响应
them;	他们
days	天
buck	巴克
happened	发生
switches	开关
shrank	萎缩
clever	聪明
console	控制台
panel	面板
behind	背后
inconvenience	不便
slab	板
mad	疯狂
mmm	嗯
thaw	融
feelthy	诲淫的
bucks	雄鹿
reflectively	沉思
her	她
lot	很多疯狂的
prodded	戳
it;	它
stairs	楼梯
pot	锅
sire	陛下
abuse	滥用
aw	AW
signals	信号
regretted	后悔
blinking	闪烁
races	种族
trusted	可信
vehicles	车辆
connection	连接
foreheads	额头
silenced	沉默
disturbed	干扰
empty;	空的
sandwiches	三明治
toga	托加
yours	你
flowers	花
elephants	大象
lobby	大堂
noses	鼻子
natural	自然
visible	可见
till	直到
whirring	呼呼
disintegrated	解体
vision	视觉
face	脸
cost	成本
fairly	相当
any)	任何
row	排
choosing	选择
already	托马斯已经
revealed	透露
rescued	救出
plants	植物
frosting	结霜
meaningful	意义
observant	细心的
may	可能
models	模型
searing	灼热的
horsey	马
invulnerable	无懈可击
environment	环境
re	重新
monterey	蒙特雷
build	建立
decorations	装饰
martin	马丁
often	经常
vultures	秃鹫
hansel	汉斯
signed	签署
kind	种
trick	招
vatch	看
lucille	露西尔
pieces	件
would	会
heading	标题
clad	复合
ribs	肋骨
clerk	职员
current	电流
flock	羊群
unceremoniously	毫不客气地
reckoning	推算
speeding	超速
repelling	排斥
8	8
headache	头痛
introduced	介绍
store	店
put	把
room	室
childhood	童年
laboratories	实验室
anxious	焦虑
elaborate	精心
concentrated	集中
ronald	罗纳德
replacing	取代
ash	灰
south	南
antenna	天线
causing	造成
smiled	笑了
scotland	苏格兰
hmm	HMM
specific	具体
parading	游行的
outta	离开
creaked	作响
episodes	发作
only	只有
diagnosis	诊断
escaped	逃
911	911
gosh	啊
eww	哦
such	这样的
my	我
customers	客户
lawyers	律师
bowels	肠
cheerful	开朗
yum	百胜
trillion	万亿
feast	盛宴
suddenly	突然
taking	在
around	电器
appliances	泽
ze	辐条
spoked	指出
noted	英里
miles	偏执
paranoid	希望
wished	撞
oh	哦
billion	亿
eyed	眼
tracers	示踪剂
mummy	木乃伊
effect	效果
slice	片
imitation	模仿
frankie	弗兰基
whaddya	你
ruby	红宝石
rude	粗鲁
strength	强度
bothers	困扰
logically	逻辑
dissolved	溶解
shrilly	刺耳
do;	做
offering	提供
drawl	拉长
special	特别
files	文件
spread	传播
hissing	嘶嘶
energy	能源
replying	回复
oil	油
dressing	敷料
inad	INAD
jr	JR
switzerland	瑞士
cab	出租车
kitty	凯蒂
43	43
brightest	亮
being	被
suit	西装
wolfing	狼吞虎咽地
roman	罗马
tired	累
tentatively	初步
tap	水龙头
receiving	接收
garden	花园
slugged	打
havanas	哈瓦那
copyright	版权
cracked	破解
smart	智能
blame	怪
advanced	先进的
sticky	粘
properties	性能
glass	玻璃
buggin	走
addicts	成瘾者
dead	死
mailman	邮递员
sacrifice	牺牲
authorized	授权
scaling	缩放
clerks	职员
jeer	嘲笑
rephrased	改写
skin	皮肤
whims	率性
power	功率
dig	挖
miserably	惨
aliens	外星人
tea	茶
traveled	旅行
chewed	咀嚼
chance	机会
glee	欢乐
poise	风度
able	能
together	一起
perked	活跃
checksums	校验
refuses	拒绝
saber	军刀
seventy	七十
lose	失去
dey	他们
wild	野生
shepherd	牧羊
was	是
est	EST
mindedly	心不在焉
driven	驱动
like	像
help	帮助
false	假
race	种族
roared	吼
funicello	Funicello
glued	粘
bakelite	胶木
isotope	同位素
net	净
perspective	视角
contact	接触
franglia	franglia
nebraska	内布拉斯加州
nice	好
conceded	承认
grin	笑
sunshine	阳光
seven	七
miffed	恼火
girls	女孩
leafy	绿叶
non	非
provolonicus	provolonicus
tinny	细小的
tactical	战术
usual	通常
gives	给
square	平方
we	我们
even	甚至
listen	听
eclair	小饼
gentlemen	先生们
time	时间
ist	是
peacefully	和平
fixed	固定
shelves	货架
self	自
overthrow	推翻
anyone	人
skinny	瘦
disgusted	厌恶
worry	担心
undiscovered	未知
stains	污渍
ruin	面临破产
vibrating	振动
walked	走
clicked	点击
branches	分支
waves	波
dashboard	仪表板
charged	带电
comes	来
grabbed	抓住
incredulously	难以置信
celebrities	名人
flopped	失败
nauseous	恶心
mused	沉思
cheddar	切达
driver	司机
ghost	鬼
embarrassed	尴尬
considered	统一考虑
simple	简单
soothe	抚慰
mostly	数十亿大多
snickering	窃笑
mood	心情
positions	位置
reminds	提醒
disoriented	迷失方向
sorry	抱歉
libbed	信口开河的
disgusting	恶心
shifting	移
sleeping	睡
prove	证明
whether	是否
wearily	疲劳
inferior	下
soldiers	士兵
unsanitary	不卫生
asked	问
marcus	马库斯
used	用
simulated	模拟
barricade	路障
convertible	转换
sandstone	砂岩
hell	地狱
suggested	建议
woman	女人
lamp	灯
car	车
died	死
i	我
no	没有
inside	里面
area	地区
regarding	对于
scoffed	嗤之以鼻
butler	巴特勒
explanations	解释
book	书
rustic	乡村
munching	咀嚼
evidence	证据
dunno	不知道
deliver	提供
button	按钮
recognition	识别
hiding	隐藏
leaping	跳跃的
locomotive;	机车
nicely	好
resembled	像
eagerly	急切地
desert	沙漠
destroying	破坏
expressions	表达
breathing	呼吸
fixing	固定
tremendous	巨大的
electrodes	电极
acme	极致
evolved	演变
thousand	千
fight	战斗
nah	不
chill	寒意
polyester	聚酯
vito	维托
nez	该
inspection	检验
shutters	百叶窗
card	卡
actually	其实
armed	武装
349	349
lifting	提升
ralph	拉尔夫
paranoia	偏执
4472b	4472b
forms	形式
slammed	抨击
blew	吹
blundered	跌跌撞撞地
instance	实例
om	OM
blinding	致盲
fresh	新鲜
commando	突击队
kinder	更不幸的是
slippers	拖鞋
mississippi	密西西比
he	他
dispiritedly	颓废
angry	生气
been	被
pillage	掠夺
horsepower	马力
next	下一
beg	求
contestant	选手
great	大
sorting	排序
baking	烘烤
sagely	圣明的
perspire	出汗
corruption	腐败
rested	休息
bloody	血腥的
jubilantly	兴高采烈地
directly	直接
technician	技师
monstrosity	怪物
questioned	质疑
whinnying	嘶声
void	无效
cope	应付
should	应该
94	94
national	国家
prettier	漂亮
gave	给
powers	权力
revealing	揭示
exactly	到底
15	15
sort	排序
bottom	底
you	你
worth	值得
muzzles	枪口
mighta	可能
doo	斗
proteins	蛋白
pick	接
von	冯
scale	规模
dripping	滴
tulips	郁金香
spaceship	飞船
uncertainly	不
vere	维尔
assumed	假定
tear	撕裂
spell	法术
mashed	捣碎
rectangle	矩形
happenin	发生
planet	行星
rollers	辊
pseudopods	伪足
complained	抱怨
reggae	雷鬼
place	地方
odd	奇
splotches	斑点
bite	咬
symbol	符号
goatee	山羊胡子
start	开始
tire	轮胎
refund	退款
heartbreak	心碎
financial	金融
second	二
caviar	鱼子酱
both	都
corroded	腐蚀
purpose	目的
quadrillion	万亿
destroyed	摧毁
gunsmoke	硝烟
images	图像
rose	玫瑰
contentedly	心满意足地
consternation	惊愕
desi	设计
egyptian	埃及
pulled	拉
shriek	尖叫
scene	场景
mention	提
calls	电话
nazis	纳粹
sparkle	闪耀
mirror	镜
paperwork	文书写作
bet	打赌
clothing	服装
faithful	忠实
appointed	任命
luna	月神
torte	蛋糕
ssh	SSH
amused	逗乐
lacking	缺乏
thunderous	雷鸣
rent	租
ye	你们
practically	几乎
aproached	探讨
unusually	异常
embryos	胚胎
uncanny	不可思议的
archaeological	考古
stiffened	加劲
foggiest	甚少
another	另一个
trouble	麻烦
thoughtful	周到
barbarian	野蛮
modern	现代
grumbled	抱怨
knocked	敲
expertise	专长
showing	显示
itself	本身
heidelberg	海德堡
secure	安全
cage	笼
aww	啊
contribution	贡献
nose	鼻子
handing	处理
braids	辫子
beauty	美
lifted	解除
bred	培育特色
focus	焦点
villagers	村民
huh	哈
carrots	胡萝卜
seventh	第七
noon	中午
dollar	美元
ill	生病
composedly	从容地
walls	墙
emaciated;	瘦弱
ask	问
somewhat	有些
fidgeting	坐立不安
dreadful	可怕的
applauding	鼓掌
ruse	诡计
kansas	堪萨斯
secretaries	秘书
multifaceted	多面
guessed	回答猜
pause	暂停
notification	通知
folded	折叠
calmer	平静
delicate	细腻
plaid	格子
roar	咆哮
ship	船
laying	铺设
blown	吹
occurred	发生
furrowed	皱
rabbit	兔
uniform	均匀
roof	屋顶
ten	十
shuffling	洗牌
rolex	劳力士
backwards	向后旋转
trigger	触发
coughed	咳嗽
here	这里
frozen	冷冻
bathroom	浴室
pyramids	金字塔
1950	1950
sets	集
dragons	龙
scribbling	涂鸦
arrows	箭
tended	往往
mountains	山
conquer	征服
televisions	电视
exasperatedly	exasperatedly
directions	方向
forgot	忘了
forgotten	遗忘
gust	阵风
avay	清楚
case	案例
creature	生物
heels	高跟鞋
and	和
crashing	崩溃
looked	看了后
sunday	星期日
shimmered	闪烁
tuned	调谐
waited	等
negligees	睡衣
clue	线索
checked	检查
fence	栅栏
47	47
spacelane	spacelane
appeared	出现
coconut	椰子
manners	礼仪
kitchen	厨房
pain	疼痛
barred	禁止
town	镇
thoughtfully	最
most	若有所思地
sticking	粘
wide	宽
everywhere	到处
shtop	shtop
mysteriously	神秘
rest	休息
stomach	胃
persian	波斯
tip	提示
acres	亩
upsets	冷门
loudly	大声
price	价格
misgivings	疑虑
caesar	凯撒
tatters	支离破碎
but	但
diabolically	飞转
every	每一
key	关键
lovely	可爱的
send	送
wildly	广泛
zese	泽瑟
hey	嘿
nonplussed	狼狈
tsk	TSK
hopeless	绝望
sounds	听起来
arrived	到达
triggers	触发
mystery	神秘
withered	枯萎
horst	地垒
rush	冲
guests	客人
choice	选择
iron	铁
major	主要
consider	考虑
nuisance	滋扰
seams	接缝
wart	疣
see)	看到
derisively	嘲笑
glad	高兴
chanting	诵经
insectile	昆虫
malevolently	恶意的
reassuringly	安慰
impenetrable	坚不可摧的
obliged	义务
carved	雕刻
enormous	巨大的
move	移动
outer	外
perhaps	也许
startled	惊
ain	是
granted	授予
decides	决定
horror	恐怖
tray	托盘
say	说
catch	抓
wasn	并
shivering	颤抖
0028	0028
proceedings	诉讼
burned	烧
properly	妥善
furniture	家具
looted	洗劫
sentence	句
lordship	大人
white	白
whispered	低声
tow	拖
protest	抗议
sob	哭泣
lighter	打火机
lip	唇
tails	尾巴
handset	手机
screw	螺杆
once	一旦
nervous	紧张
peruse	细读
companions	同伴
excuse	借口
married	结婚
occasionally	偶尔
whats	什么
locked	锁定
hurry	快点
19th	第十九
oops	哎呀
fingered	指
prizes	奖品
governments	政府
new	新
downward	向下
along	沿
gripping	扣人心弦的
imagined	想象
slumped	暴跌
cabinet	柜
comments	评论
keys	键
cured	治愈
talked	谈
toward	向
cyperspace	cyperspace
truck	卡车
flip	翻转
ice	冰
alcoholic	酒精
prepare	准备
computation	计算
retrieved	检索
acted	行动
chu	楚
jump	跳
furnished	提供
dancer	舞者
oom	OOM
ladies	女士们
marshal	元帅
flu	流感
consistent	一致
networked	网络
dozed	打瞌睡
solar	太阳能
repair	修复
awestruck	肃然起敬
collectors	收藏家
humans	人类
sheepish	羞怯的
rpm	转
keen	敏锐的
accidentally	意外
placated	安抚
accrued	计
stuttered	结巴
managed	管理
lashing	绑扎
pleasantly	愉快的
interrupted	中断
concluded	总结
regarded	视
unhealthy	不良
maybe	也许
epilogue	结语
telling	告诉
numero	22:16
borrow	借
forever	永远
resolve	解决
thinks	认为
arm	臂
c8	C8
tomorrow	明天
tearin	tearin
top	顶
singing	唱歌
kidneys	肾脏
knowledge	知识
cone	锥
acutely	急性
sobbing	抽泣
uh	呃
games	游戏
chorused	异口同声的
notice	通知
blueberries	蓝莓
attempts	尝试
isn	是
rumpled	皱巴巴的
surprisingly	出奇的
carefully	仔细
antique	古董
sanitary	卫生
wore	穿着
saloon	轿车
29	29
mostel	莫斯特尔
indistinct	模糊的
seriously	严重
pleasant	愉快的
containing	含
intrigued	好奇
mansion	大厦
sheet	片
growing	生长
contained	包含
computer	计算机
decorated	装饰
peeg	pEEG
million	万
gestured	示意
growled	咆哮着
devils	魔鬼
fer	FER
enthusiastically	踊跃
fragment	片段
bully	欺负
try	试着
crestfallen	垂头丧气
comfortingly	安慰
haven	还
gut	肠道
box	箱
stopping	停止
unmercifully	无情
religious	宗教
cell	细胞
boats	船上
whereabouts	下落
thighs	大腿
towards	向
huge	巨大的
blast	爆炸
cylinder	缸
difficulties	困难
blamed	指责
broad	广阔的
fitted	安装
strong	强
trekking	徒步
tag	标签
seems	似乎
tasteful	雅致的
fe	铁
dismay	沮丧
b)the	B的
laughing	笑
argue	认为
sabotage	破坏
indicated	表示
thrust	推力
menace;	威胁
vette	维特
changing	改变
bare	裸
clang	铿锵
glowing	发光的
anymore	了
rotten	烂
pawed	利
lightning	闪电
mater	母校
sprinted	冲
commiseratingly	怜悯地
neural	神经
devices	设备
seeing	看到
enthusiasm	热情
clothes	衣服
interruption	中断
strip	条
disgust	厌恶
embryo	胚胎
wears	穿
franchised)	专营
feats	功勋
where	在
dog	狗
shoe	鞋
quill	羽毛
recognized	认可
favorably	毫不逊色
soda	苏打
section	部分
advancing	推进
bic	BIC
caught	抓住
cutting	切割
dominant	主导
upon	在
a)your	一你的
civilizations	文明
felt	感到
relief	救济
versions	版本
sure	肯定
deductible	扣除
yabba	yabba
treat	治疗
invoice	发票
aything	事
cabinets	柜
affects	影响
tyranny	暴政
washes	洗擦
middle	中
scream	尖叫
sheath	鞘
popular	流行
adam	亚当
script	脚本
shirley	雪莉
holder	持有人
mickey	米
drew	画
string	字符串
din	DIN
accounting	会计
exasperation	愤怒
sympathy	同情
makers	者
darkened	昏暗的
switched	切换
operate	操作
plate	板
needle	针
kent	肯特
planets	行星
summer	夏天
window	窗口
blanched	脱皮
strangest	奇怪的
examine	检查
really	真的
write	写
chapter	第
foot	脚
actions	行动
dozens	几十
material	材料
phony	假
validation	验证
luster	光泽
shtupidity	shtupidity
fleeing	逃离
gratefully	感激
mythological	神话
away	走
flashlights	手电筒
mainframe	主机
whatsa	whatsa
torture	折磨
sundays	周日
sinai	西奈
argued	争论
diet	饮食
accompanied	陪同
agree	同意
e4	E4
sensational	耸人听闻的
knock	敲
zee	Zee
crags	峭壁
reflexively	本能地
scanned	扫描
tin	锡
raged	肆虐
looks	看起来
heaved	叹
beep	哔
malicious	恶意
muscled	肌肉
increase	增加
forcing	迫使
vengeance	复仇
fixedly	固定
individual	个人
watches	手表
supervisor	主管
species	物种
dinner	晚餐
too	太
sweetness	甜蜜
lassie	莱西
master	大师
crap	废话
cubicle	柜
temperedly	宽容地
e	E
bullfighter	斗牛士
silent	无声地
stricken	灾区
hate	恨
intensity	强度
boss	老板
tones	音调
jets	飞机
abashed	羞
reasoning	推理
upward	上升
ungph	ungph
strangers	陌生人
asserted	断言
minor	小调
412	412
1991	1991
sum	和
vas	VAS
encouragingly	鼓励
hamburger	汉堡
lumpiness	凹凸不平
shampoo	洗发水
letters	道歉信
kingdom;	王国
closest	亲密地
mom	妈妈
genetic	遗传
blandings	布兰汀斯
dollars	美元
crawled	爬
doctor	医生
ashes	灰烬
fluke	福禄克
software	软件
levels	水平
for	为
incomprehensible	不可思议的
letter	信
pay	支付
work	工作
music	音乐
joyously	快乐
blank	空白
mouths	嘴
hully	丘陵
inner	内
toppled	推翻
regular	定期
stir	搅拌
it	它
hair	头发
regain	恢复
believably	很
screen	屏幕
slow	慢
won	赢得
handed	递给
needing	需要
vhirling	vhirling
of	可怜的
poor	简洁
grassy	草
insofar	在
manner	方式
proceed	进行
tape	带
mechanical	机械
fidgeted	坐立不安
brazen	厚颜无耻的
chimed	帮腔
intent	意图
handle	处理
noticing	注意
became	成为
uniforms	制服
snout	鼻子
gun	枪
accusingly	责难地
always	总是
babes	辣妹
08f1	08f1
9	9
again;	再次
leafed	叶
labelled	标记
ed	ED
teeth	牙齿生长
brightly	明亮
okay;	好
richard	李察
instead	相反
tittered	窃笑
patronizingly	盛气凌人的
suspecting	怀疑
past	过去
trivial	琐碎的
personal	个人
way	方式
sagged	下垂
faster	更快
severed	切断
silk	丝绸
therapy	治疗
different	不同
finishing	整理
pile	桩
m	M
programming	编程
haff	哈夫
numerical	数值
pound	英镑
knitted	针织
harrumphed	哼声
whirred	地
snaps	扣
dart	镖
massive	大规模
quite	相当
bore	孔
beaver	海狸
entirely	完全
panes	窗格
flashed	闪现
utter	完全
jurassic	侏罗纪
solid	固体
vis	可见
whole	整个
ability	能力
bronzer	古铜色
tricky	棘手的
thirteen	十三
polish	波兰
his	他的
movies	电影
touchy	敏感
discuss	讨论
diana	戴安娜
blocks	块
smoke	烟
hare	兔子
blowing	吹
handedly	手
since	自
unenthusiastically	冷淡
loot	战利品
candy	糖果
be	是
important	重要
stiffly	僵硬
swell	膨胀
offer	提供
old	老
fab	Fab
fished	捕捞
save	救
period	期
your	你
written	写
bohrmann	种
article	第
greeting	问候
there	有
image	图像
intensely	强烈
type	型
use	使用
fly	飞
patch	补丁
checkbook	支票簿
dos	DOS
pregnant	怀孕
diabolical	恶魔
listlessly	无精打采地
opening	开放
sham	假
dragon	龙
yes	是
struggled	挣扎
spanish	西班牙
pits	坑
diploma	文凭
true	真
tonight	今晚
rating	评级
avaiting	avaiting
looting	抢劫
telemann	泰勒曼
driving	驱动
doubles	双打
032	032
far	远
tiger	虎
manage	管理
wastebasket	废纸篓
pleasure	快乐
hesitantly	欲言又止
snap	卡
trauma	创伤
fire	火
me	我
gruesome	可怕的
dressed	穿着
cheery	活泼
conversation	谈话
1	1
barbaric	野蛮
chest	胸部
forgiven	原谅
coveralls	服
back	回来
wine	酒
attached	附
victorian	维多利亚
usually	通常
dimly	依稀
dingy	肮脏的
sharply	大幅
sealed	密封
kicked	踢
attire	服装
eggplant	茄子
pranksters	恶作剧
plain	平原
fit	适合
architects	建筑师
allowed	允许
news	新闻
broadly	广泛
designer	设计师
bugging	窃听
fabric	织物
arab	阿拉伯
sound	声音
mail	邮件
ff0c	ff0c
sprinting	冲刺
onions	洋葱
vase	花瓶
mouse	鼠标
involuntarily	不由自主地坐在沙发
muzzle	枪口
france	法国
coping	应对
brandished	挥舞
code	代码
rail	轨道
appreciate	欣赏
shows	显示
sonny	桑尼
magazines	杂志
outside	外
mud	泥
dump	转储
animation	动画
winds	风
bows	弓
extended	扩展
lever	杠杆
hidden	隐藏
seemed	似乎
mining	挖掘
771	771
gingerbread	姜饼
intelligent	智能
laughed	笑
excessive	过度
oof	哦
commanding	指挥
hint	暗示
herd	羊群
spreadsheets	表格
strategic	战略
unusual	不同寻常的
hit	打
road	路
brush	刷
point	点
long	长
hairs	毛
whoo	喔
exhausted	疲惫
spot	现货
touched	感动
swept	扫
learn	学习
fearsome	可怕的
shell	壳
disturbing	令人不安的
cans	罐
eggplants	茄子
insincerely	言不由衷
berry	浆果
monumental	不朽的
bottles	瓶
comfortably	舒适
albums	专辑
vould	vould
dashed	冲
check	检查
regained	恢复
crushed	粉碎敌人
enemies	智能识别
bother	打扰
persecuted	迫害
eyes	眼睛
spat	吐
scarf	围巾
best	最好的
smirking	傻笑
scowled	皱起了眉头
avoid	避免
invented	发明
hardly	几乎
aghast	吓呆了
patrol	巡逻
larry	拉里
corshcrew	corshcrew
enough	足够的
hypnotized	催眠
hadda	哈达
damn	该死的
stories	故事
tailored	量身定制的
subject	主体
wrong	错
appreciatively	欣赏
expensive	昂贵的
soundlessly	无声地
pool	池
calm	平静
yanked	猛拉
affected	影响
except	除了
deer	鹿
materialized	实
